ﭐ	ٱ	U+FB50 ARABIC LETTER ALEF WASLA ISOLATED FORM
ﭑ	ٱ	U+FB51 ARABIC LETTER ALEF WASLA FINAL FORM
ﭒ	ٻ	U+FB52 ARABIC LETTER BEEH ISOLATED FORM
ﭓ	ٻ	U+FB53 ARABIC LETTER BEEH FINAL FORM
ﭔ	ٻ	U+FB54 ARABIC LETTER BEEH INITIAL FORM
ﭕ	ٻ	U+FB55 ARABIC LETTER BEEH MEDIAL FORM
ﭖ	پ	U+FB56 ARABIC LETTER PEH ISOLATED FORM
ﭗ	پ	U+FB57 ARABIC LETTER PEH FINAL FORM
ﭘ	پ	U+FB58 ARABIC LETTER PEH INITIAL FORM
ﭙ	پ	U+FB59 ARABIC LETTER PEH MEDIAL FORM
ﭚ	ڀ	U+FB5A ARABIC LETTER BEHEH ISOLATED FORM
ﭛ	ڀ	U+FB5B ARABIC LETTER BEHEH FINAL FORM
ﭜ	ڀ	U+FB5C ARABIC LETTER BEHEH INITIAL FORM
ﭝ	ڀ	U+FB5D ARABIC LETTER BEHEH MEDIAL FORM
ﭞ	ٺ	U+FB5E ARABIC LETTER TTEHEH ISOLATED FORM
ﭟ	ٺ	U+FB5F ARABIC LETTER TTEHEH FINAL FORM
ﭠ	ٺ	U+FB60 ARABIC LETTER TTEHEH INITIAL FORM
ﭡ	ٺ	U+FB61 ARABIC LETTER TTEHEH MEDIAL FORM
ﭢ	ٿ	U+FB62 ARABIC LETTER TEHEH ISOLATED FORM
ﭣ	ٿ	U+FB63 ARABIC LETTER TEHEH FINAL FORM
ﭤ	ٿ	U+FB64 ARABIC LETTER TEHEH INITIAL FORM
ﭥ	ٿ	U+FB65 ARABIC LETTER TEHEH MEDIAL FORM
ﭦ	ٹ	U+FB66 ARABIC LETTER TTEH ISOLATED FORM
ﭧ	ٹ	U+FB67 ARABIC LETTER TTEH FINAL FORM
ﭨ	ٹ	U+FB68 ARABIC LETTER TTEH INITIAL FORM
ﭩ	ٹ	U+FB69 ARABIC LETTER TTEH MEDIAL FORM
ﭪ	ڤ	U+FB6A ARABIC LETTER VEH ISOLATED FORM
ﭫ	ڤ	U+FB6B ARABIC LETTER VEH FINAL FORM
ﭬ	ڤ	U+FB6C ARABIC LETTER VEH INITIAL FORM
ﭭ	ڤ	U+FB6D ARABIC LETTER VEH MEDIAL FORM
ﭮ	ڦ	U+FB6E ARABIC LETTER PEHEH ISOLATED FORM
ﭯ	ڦ	U+FB6F ARABIC LETTER PEHEH FINAL FORM
ﭰ	ڦ	U+FB70 ARABIC LETTER PEHEH INITIAL FORM
ﭱ	ڦ	U+FB71 ARABIC LETTER PEHEH MEDIAL FORM
ﭲ	ڄ	U+FB72 ARABIC LETTER DYEH ISOLATED FORM
ﭳ	ڄ	U+FB73 ARABIC LETTER DYEH FINAL FORM
ﭴ	ڄ	U+FB74 ARABIC LETTER DYEH INITIAL FORM
ﭵ	ڄ	U+FB75 ARABIC LETTER DYEH MEDIAL FORM
ﭶ	ڃ	U+FB76 ARABIC LETTER NYEH ISOLATED FORM
ﭷ	ڃ	U+FB77 ARABIC LETTER NYEH FINAL FORM
ﭸ	ڃ	U+FB78 ARABIC LETTER NYEH INITIAL FORM
ﭹ	ڃ	U+FB79 ARABIC LETTER NYEH MEDIAL FORM
ﭺ	چ	U+FB7A ARABIC LETTER TCHEH ISOLATED FORM
ﭻ	چ	U+FB7B ARABIC LETTER TCHEH FINAL FORM
ﭼ	چ	U+FB7C ARABIC LETTER TCHEH INITIAL FORM
ﭽ	چ	U+FB7D ARABIC LETTER TCHEH MEDIAL FORM
ﭾ	ڇ	U+FB7E ARABIC LETTER TCHEHEH ISOLATED FORM
ﭿ	ڇ	U+FB7F ARABIC LETTER TCHEHEH FINAL FORM
ﮀ	ڇ	U+FB80 ARABIC LETTER TCHEHEH INITIAL FORM
ﮁ	ڇ	U+FB81 ARABIC LETTER TCHEHEH MEDIAL FORM
ﮂ	ڍ	U+FB82 ARABIC LETTER DDAHAL ISOLATED FORM
ﮃ	ڍ	U+FB83 ARABIC LETTER DDAHAL FINAL FORM
ﮄ	ڌ	U+FB84 ARABIC LETTER DAHAL ISOLATED FORM
ﮅ	ڌ	U+FB85 ARABIC LETTER DAHAL FINAL FORM
ﮆ	ڎ	U+FB86 ARABIC LETTER DUL ISOLATED FORM
ﮇ	ڎ	U+FB87 ARABIC LETTER DUL FINAL FORM
ﮈ	ڈ	U+FB88 ARABIC LETTER DDAL ISOLATED FORM
ﮉ	ڈ	U+FB89 ARABIC LETTER DDAL FINAL FORM
ﮊ	ژ	U+FB8A ARABIC LETTER JEH ISOLATED FORM
ﮋ	ژ	U+FB8B ARABIC LETTER JEH FINAL FORM
ﮌ	ڑ	U+FB8C ARABIC LETTER RREH ISOLATED FORM
ﮍ	ڑ	U+FB8D ARABIC LETTER RREH FINAL FORM
ﮎ	ک	U+FB8E ARABIC LETTER KEHEH ISOLATED FORM
ﮏ	ک	U+FB8F ARABIC LETTER KEHEH FINAL FORM
ﮐ	ک	U+FB90 ARABIC LETTER KEHEH INITIAL FORM
ﮑ	ک	U+FB91 ARABIC LETTER KEHEH MEDIAL FORM
ﮒ	گ	U+FB92 ARABIC LETTER GAF ISOLATED FORM
ﮓ	گ	U+FB93 ARABIC LETTER GAF FINAL FORM
ﮔ	گ	U+FB94 ARABIC LETTER GAF INITIAL FORM
ﮕ	گ	U+FB95 ARABIC LETTER GAF MEDIAL FORM
ﮖ	ڳ	U+FB96 ARABIC LETTER GUEH ISOLATED FORM
ﮗ	ڳ	U+FB97 ARABIC LETTER GUEH FINAL FORM
ﮘ	ڳ	U+FB98 ARABIC LETTER GUEH INITIAL FORM
ﮙ	ڳ	U+FB99 ARABIC LETTER GUEH MEDIAL FORM
ﮚ	ڱ	U+FB9A ARABIC LETTER NGOEH ISOLATED FORM
ﮛ	ڱ	U+FB9B ARABIC LETTER NGOEH FINAL FORM
ﮜ	ڱ	U+FB9C ARABIC LETTER NGOEH INITIAL FORM
ﮝ	ڱ	U+FB9D ARABIC LETTER NGOEH MEDIAL FORM
ﮞ	ں	U+FB9E ARABIC LETTER NOON GHUNNA ISOLATED FORM
ﮟ	ں	U+FB9F ARABIC LETTER NOON GHUNNA FINAL FORM
ﮠ	ڻ	U+FBA0 ARABIC LETTER RNOON ISOLATED FORM
ﮡ	ڻ	U+FBA1 ARABIC LETTER RNOON FINAL FORM
ﮢ	ڻ	U+FBA2 ARABIC LETTER RNOON INITIAL FORM
ﮣ	ڻ	U+FBA3 ARABIC LETTER RNOON MEDIAL FORM
ﮤ	ۀ	U+FBA4 ARABIC LETTER HEH WITH YEH ABOVE ISOLATED FORM
ﮥ	ۀ	U+FBA5 ARABIC LETTER HEH WITH YEH ABOVE FINAL FORM
ﮦ	ہ	U+FBA6 ARABIC LETTER HEH GOAL ISOLATED FORM
ﮧ	ہ	U+FBA7 ARABIC LETTER HEH GOAL FINAL FORM
ﮨ	ہ	U+FBA8 ARABIC LETTER HEH GOAL INITIAL FORM
ﮩ	ہ	U+FBA9 ARABIC LETTER HEH GOAL MEDIAL FORM
ﮪ	ھ	U+FBAA ARABIC LETTER HEH DOACHASHMEE ISOLATED FORM
ﮫ	ھ	U+FBAB ARABIC LETTER HEH DOACHASHMEE FINAL FORM
ﮬ	ھ	U+FBAC ARABIC LETTER HEH DOACHASHMEE INITIAL FORM
ﮭ	ھ	U+FBAD ARABIC LETTER HEH DOACHASHMEE MEDIAL FORM
ﮮ	ے	U+FBAE ARABIC LETTER YEH BARREE ISOLATED FORM
ﮯ	ے	U+FBAF ARABIC LETTER YEH BARREE FINAL FORM
ﮰ	ۓ	U+FBB0 ARABIC LETTER YEH BARREE WITH HAMZA ABOVE ISOLATED FORM
ﮱ	ۓ	U+FBB1 ARABIC LETTER YEH BARREE WITH HAMZA ABOVE FINAL FORM
ﯓ	ڭ	U+FBD3 ARABIC LETTER NG ISOLATED FORM
ﯔ	ڭ	U+FBD4 ARABIC LETTER NG FINAL FORM
ﯕ	ڭ	U+FBD5 ARABIC LETTER NG INITIAL FORM
ﯖ	ڭ	U+FBD6 ARABIC LETTER NG MEDIAL FORM
ﯗ	ۇ	U+FBD7 ARABIC LETTER U ISOLATED FORM
ﯘ	ۇ	U+FBD8 ARABIC LETTER U FINAL FORM
ﯙ	ۆ	U+FBD9 ARABIC LETTER OE ISOLATED FORM
ﯚ	ۆ	U+FBDA ARABIC LETTER OE FINAL FORM
ﯛ	ۈ	U+FBDB ARABIC LETTER YU ISOLATED FORM
ﯜ	ۈ	U+FBDC ARABIC LETTER YU FINAL FORM
ﯝ	ٷ	U+FBDD ARABIC LETTER U WITH HAMZA ABOVE ISOLATED FORM
ﯞ	ۋ	U+FBDE ARABIC LETTER VE ISOLATED FORM
ﯟ	ۋ	U+FBDF ARABIC LETTER VE FINAL FORM
ﯠ	ۅ	U+FBE0 ARABIC LETTER KIRGHIZ OE ISOLATED FORM
ﯡ	ۅ	U+FBE1 ARABIC LETTER KIRGHIZ OE FINAL FORM
ﯢ	ۉ	U+FBE2 ARABIC LETTER KIRGHIZ YU ISOLATED FORM
ﯣ	ۉ	U+FBE3 ARABIC LETTER KIRGHIZ YU FINAL FORM
ﯤ	ې	U+FBE4 ARABIC LETTER E ISOLATED FORM
ﯥ	ې	U+FBE5 ARABIC LETTER E FINAL FORM
ﯦ	ې	U+FBE6 ARABIC LETTER E INITIAL FORM
ﯧ	ې	U+FBE7 ARABIC LETTER E MEDIAL FORM
ﯨ	ى	U+FBE8 ARABIC LETTER UIGHUR KAZAKH KIRGHIZ ALEF MAKSURA INITIAL FORM
ﯩ	ى	U+FBE9 ARABIC LETTER UIGHUR KAZAKH KIRGHIZ ALEF MAKSURA MEDIAL FORM
ﯪ	ئا	U+FBEA ARABIC LIGATURE YEH WITH HAMZA ABOVE WITH ALEF ISOLATED FORM
ﯫ	ئا	U+FBEB ARABIC LIGATURE YEH WITH HAMZA ABOVE WITH ALEF FINAL FORM
ﯬ	ئە	U+FBEC ARABIC LIGATURE YEH WITH HAMZA ABOVE WITH AE ISOLATED FORM
ﯭ	ئە	U+FBED ARABIC LIGATURE YEH WITH HAMZA ABOVE WITH AE FINAL FORM
ﯮ	ئو	U+FBEE ARABIC LIGATURE YEH WITH HAMZA ABOVE WITH WAW ISOLATED FORM
ﯯ	ئو	U+FBEF ARABIC LIGATURE YEH WITH HAMZA ABOVE WITH WAW FINAL FORM
ﯰ	ئۇ	U+FBF0 ARABIC LIGATURE YEH WITH HAMZA ABOVE WITH U ISOLATED FORM
ﯱ	ئۇ	U+FBF1 ARABIC LIGATURE YEH WITH HAMZA ABOVE WITH U FINAL FORM
ﯲ	ئۆ	U+FBF2 ARABIC LIGATURE YEH WITH HAMZA ABOVE WITH OE ISOLATED FORM
ﯳ	ئۆ	U+FBF3 ARABIC LIGATURE YEH WITH HAMZA ABOVE WITH OE FINAL FORM
ﯴ	ئۈ	U+FBF4 ARABIC LIGATURE YEH WITH HAMZA ABOVE WITH YU ISOLATED FORM
ﯵ	ئۈ	U+FBF5 ARABIC LIGATURE YEH WITH HAMZA ABOVE WITH YU FINAL FORM
ﯶ	ئې	U+FBF6 ARABIC LIGATURE YEH WITH HAMZA ABOVE WITH E ISOLATED FORM
ﯷ	ئې	U+FBF7 ARABIC LIGATURE YEH WITH HAMZA ABOVE WITH E FINAL FORM
ﯸ	ئې	U+FBF8 ARABIC LIGATURE YEH WITH HAMZA ABOVE WITH E INITIAL FORM
ﯹ	ئى	U+FBF9 ARABIC LIGATURE UIGHUR KIRGHIZ YEH WITH HAMZA ABOVE WITH ALEF MAKSURA ISOLATED FORM
ﯺ	ئى	U+FBFA ARABIC LIGATURE UIGHUR KIRGHIZ YEH WITH HAMZA ABOVE WITH ALEF MAKSURA FINAL FORM
ﯻ	ئى	U+FBFB ARABIC LIGATURE UIGHUR KIRGHIZ YEH WITH HAMZA ABOVE WITH ALEF MAKSURA INITIAL FORM
ﯼ	ی	U+FBFC ARABIC LETTER FARSI YEH ISOLATED FORM
ﯽ	ی	U+FBFD ARABIC LETTER FARSI YEH FINAL FORM
ﯾ	ی	U+FBFE ARABIC LETTER FARSI YEH INITIAL FORM
ﯿ	ی	U+FBFF ARABIC LETTER FARSI YEH MEDIAL FORM
ﰀ	ئج	U+FC00 ARABIC LIGATURE YEH WITH HAMZA ABOVE WITH JEEM ISOLATED FORM
ﰁ	ئح	U+FC01 ARABIC LIGATURE YEH WITH HAMZA ABOVE WITH HAH ISOLATED FORM
ﰂ	ئم	U+FC02 ARABIC LIGATURE YEH WITH HAMZA ABOVE WITH MEEM ISOLATED FORM
ﰃ	ئى	U+FC03 ARABIC LIGATURE YEH WITH HAMZA ABOVE WITH ALEF MAKSURA ISOLATED FORM
ﰄ	ئي	U+FC04 ARABIC LIGATURE YEH WITH HAMZA ABOVE WITH YEH ISOLATED FORM
ﰅ	بج	U+FC05 ARABIC LIGATURE BEH WITH JEEM ISOLATED FORM
ﰆ	بح	U+FC06 ARABIC LIGATURE BEH WITH HAH ISOLATED FORM
ﰇ	بخ	U+FC07 ARABIC LIGATURE BEH WITH KHAH ISOLATED FORM
ﰈ	بم	U+FC08 ARABIC LIGATURE BEH WITH MEEM ISOLATED FORM
ﰉ	بى	U+FC09 ARABIC LIGATURE BEH WITH ALEF MAKSURA ISOLATED FORM
ﰊ	بي	U+FC0A ARABIC LIGATURE BEH WITH YEH ISOLATED FORM
ﰋ	تج	U+FC0B ARABIC LIGATURE TEH WITH JEEM ISOLATED FORM
ﰌ	تح	U+FC0C ARABIC LIGATURE TEH WITH HAH ISOLATED FORM
ﰍ	تخ	U+FC0D ARABIC LIGATURE TEH WITH KHAH ISOLATED FORM
ﰎ	تم	U+FC0E ARABIC LIGATURE TEH WITH MEEM ISOLATED FORM
ﰏ	تى	U+FC0F ARABIC LIGATURE TEH WITH ALEF MAKSURA ISOLATED FORM
ﰐ	تي	U+FC10 ARABIC LIGATURE TEH WITH YEH ISOLATED FORM
ﰑ	ثج	U+FC11 ARABIC LIGATURE THEH WITH JEEM ISOLATED FORM
ﰒ	ثم	U+FC12 ARABIC LIGATURE THEH WITH MEEM ISOLATED FORM
ﰓ	ثى	U+FC13 ARABIC LIGATURE THEH WITH ALEF MAKSURA ISOLATED FORM
ﰔ	ثي	U+FC14 ARABIC LIGATURE THEH WITH YEH ISOLATED FORM
ﰕ	جح	U+FC15 ARABIC LIGATURE JEEM WITH HAH ISOLATED FORM
ﰖ	جم	U+FC16 ARABIC LIGATURE JEEM WITH MEEM ISOLATED FORM
ﰗ	حج	U+FC17 ARABIC LIGATURE HAH WITH JEEM ISOLATED FORM
ﰘ	حم	U+FC18 ARABIC LIGATURE HAH WITH MEEM ISOLATED FORM
ﰙ	خج	U+FC19 ARABIC LIGATURE KHAH WITH JEEM ISOLATED FORM
ﰚ	خح	U+FC1A ARABIC LIGATURE KHAH WITH HAH ISOLATED FORM
ﰛ	خم	U+FC1B ARABIC LIGATURE KHAH WITH MEEM ISOLATED FORM
ﰜ	سج	U+FC1C ARABIC LIGATURE SEEN WITH JEEM ISOLATED FORM
ﰝ	سح	U+FC1D ARABIC LIGATURE SEEN WITH HAH ISOLATED FORM
ﰞ	سخ	U+FC1E ARABIC LIGATURE SEEN WITH KHAH ISOLATED FORM
ﰟ	سم	U+FC1F ARABIC LIGATURE SEEN WITH MEEM ISOLATED FORM
ﰠ	صح	U+FC20 ARABIC LIGATURE SAD WITH HAH ISOLATED FORM
ﰡ	صم	U+FC21 ARABIC LIGATURE SAD WITH MEEM ISOLATED FORM
ﰢ	ضج	U+FC22 ARABIC LIGATURE DAD WITH JEEM ISOLATED FORM
ﰣ	ضح	U+FC23 ARABIC LIGATURE DAD WITH HAH ISOLATED FORM
ﰤ	ضخ	U+FC24 ARABIC LIGATURE DAD WITH KHAH ISOLATED FORM
ﰥ	ضم	U+FC25 ARABIC LIGATURE DAD WITH MEEM ISOLATED FORM
ﰦ	طح	U+FC26 ARABIC LIGATURE TAH WITH HAH ISOLATED FORM
ﰧ	طم	U+FC27 ARABIC LIGATURE TAH WITH MEEM ISOLATED FORM
ﰨ	ظم	U+FC28 ARABIC LIGATURE ZAH WITH MEEM ISOLATED FORM
ﰩ	عج	U+FC29 ARABIC LIGATURE AIN WITH JEEM ISOLATED FORM
ﰪ	عم	U+FC2A ARABIC LIGATURE AIN WITH MEEM ISOLATED FORM
ﰫ	غج	U+FC2B ARABIC LIGATURE GHAIN WITH JEEM ISOLATED FORM
ﰬ	غم	U+FC2C ARABIC LIGATURE GHAIN WITH MEEM ISOLATED FORM
ﰭ	فج	U+FC2D ARABIC LIGATURE FEH WITH JEEM ISOLATED FORM
ﰮ	فح	U+FC2E ARABIC LIGATURE FEH WITH HAH ISOLATED FORM
ﰯ	فخ	U+FC2F ARABIC LIGATURE FEH WITH KHAH ISOLATED FORM
ﰰ	فم	U+FC30 ARABIC LIGATURE FEH WITH MEEM ISOLATED FORM
ﰱ	فى	U+FC31 ARABIC LIGATURE FEH WITH ALEF MAKSURA ISOLATED FORM
ﰲ	في	U+FC32 ARABIC LIGATURE FEH WITH YEH ISOLATED FORM
ﰳ	قح	U+FC33 ARABIC LIGATURE QAF WITH HAH ISOLATED FORM
ﰴ	قم	U+FC34 ARABIC LIGATURE QAF WITH MEEM ISOLATED FORM
ﰵ	قى	U+FC35 ARABIC LIGATURE QAF WITH ALEF MAKSURA ISOLATED FORM
ﰶ	قي	U+FC36 ARABIC LIGATURE QAF WITH YEH ISOLATED FORM
ﰷ	كا	U+FC37 ARABIC LIGATURE KAF WITH ALEF ISOLATED FORM
ﰸ	كج	U+FC38 ARABIC LIGATURE KAF WITH JEEM ISOLATED FORM
ﰹ	كح	U+FC39 ARABIC LIGATURE KAF WITH HAH ISOLATED FORM
ﰺ	كخ	U+FC3A ARABIC LIGATURE KAF WITH KHAH ISOLATED FORM
ﰻ	كل	U+FC3B ARABIC LIGATURE KAF WITH LAM ISOLATED FORM
ﰼ	كم	U+FC3C ARABIC LIGATURE KAF WITH MEEM ISOLATED FORM
ﰽ	كى	U+FC3D ARABIC LIGATURE KAF WITH ALEF MAKSURA ISOLATED FORM
ﰾ	كي	U+FC3E ARABIC LIGATURE KAF WITH YEH ISOLATED FORM
ﰿ	لج	U+FC3F ARABIC LIGATURE LAM WITH JEEM ISOLATED FORM
ﱀ	لح	U+FC40 ARABIC LIGATURE LAM WITH HAH ISOLATED FORM
ﱁ	لخ	U+FC41 ARABIC LIGATURE LAM WITH KHAH ISOLATED FORM
ﱂ	لم	U+FC42 ARABIC LIGATURE LAM WITH MEEM ISOLATED FORM
ﱃ	لى	U+FC43 ARABIC LIGATURE LAM WITH ALEF MAKSURA ISOLATED FORM
ﱄ	لي	U+FC44 ARABIC LIGATURE LAM WITH YEH ISOLATED FORM
ﱅ	مج	U+FC45 ARABIC LIGATURE MEEM WITH JEEM ISOLATED FORM
ﱆ	مح	U+FC46 ARABIC LIGATURE MEEM WITH HAH ISOLATED FORM
ﱇ	مخ	U+FC47 ARABIC LIGATURE MEEM WITH KHAH ISOLATED FORM
ﱈ	مم	U+FC48 ARABIC LIGATURE MEEM WITH MEEM ISOLATED FORM
ﱉ	مى	U+FC49 ARABIC LIGATURE MEEM WITH ALEF MAKSURA ISOLATED FORM
ﱊ	مي	U+FC4A ARABIC LIGATURE MEEM WITH YEH ISOLATED FORM
ﱋ	نج	U+FC4B ARABIC LIGATURE NOON WITH JEEM ISOLATED FORM
ﱌ	نح	U+FC4C ARABIC LIGATURE NOON WITH HAH ISOLATED FORM
ﱍ	نخ	U+FC4D ARABIC LIGATURE NOON WITH KHAH ISOLATED FORM
ﱎ	نم	U+FC4E ARABIC LIGATURE NOON WITH MEEM ISOLATED FORM
ﱏ	نى	U+FC4F ARABIC LIGATURE NOON WITH ALEF MAKSURA ISOLATED FORM
ﱐ	ني	U+FC50 ARABIC LIGATURE NOON WITH YEH ISOLATED FORM
ﱑ	هج	U+FC51 ARABIC LIGATURE HEH WITH JEEM ISOLATED FORM
ﱒ	هم	U+FC52 ARABIC LIGATURE HEH WITH MEEM ISOLATED FORM
ﱓ	هى	U+FC53 ARABIC LIGATURE HEH WITH ALEF MAKSURA ISOLATED FORM
ﱔ	هي	U+FC54 ARABIC LIGATURE HEH WITH YEH ISOLATED FORM
ﱕ	يج	U+FC55 ARABIC LIGATURE YEH WITH JEEM ISOLATED FORM
ﱖ	يح	U+FC56 ARABIC LIGATURE YEH WITH HAH ISOLATED FORM
ﱗ	يخ	U+FC57 ARABIC LIGATURE YEH WITH KHAH ISOLATED FORM
ﱘ	يم	U+FC58 ARABIC LIGATURE YEH WITH MEEM ISOLATED FORM
ﱙ	يى	U+FC59 ARABIC LIGATURE YEH WITH ALEF MAKSURA ISOLATED FORM
ﱚ	يي	U+FC5A ARABIC LIGATURE YEH WITH YEH ISOLATED FORM
ﱛ	ذٰ	U+FC5B ARABIC LIGATURE THAL WITH SUPERSCRIPT ALEF ISOLATED FORM
ﱜ	رٰ	U+FC5C ARABIC LIGATURE REH WITH SUPERSCRIPT ALEF ISOLATED FORM
ﱝ	ىٰ	U+FC5D ARABIC LIGATURE ALEF MAKSURA WITH SUPERSCRIPT ALEF ISOLATED FORM
ﱞ	 ٌّ	U+FC5E ARABIC LIGATURE SHADDA WITH DAMMATAN ISOLATED FORM
ﱟ	 ٍّ	U+FC5F ARABIC LIGATURE SHADDA WITH KASRATAN ISOLATED FORM
ﱠ	 َّ	U+FC60 ARABIC LIGATURE SHADDA WITH FATHA ISOLATED FORM
ﱡ	 ُّ	U+FC61 ARABIC LIGATURE SHADDA WITH DAMMA ISOLATED FORM
ﱢ	 ِّ	U+FC62 ARABIC LIGATURE SHADDA WITH KASRA ISOLATED FORM
ﱣ	 ّٰ	U+FC63 ARABIC LIGATURE SHADDA WITH SUPERSCRIPT ALEF ISOLATED FORM
ﱤ	ئر	U+FC64 ARABIC LIGATURE YEH WITH HAMZA ABOVE WITH REH FINAL FORM
ﱥ	ئز	U+FC65 ARABIC LIGATURE YEH WITH HAMZA ABOVE WITH ZAIN FINAL FORM
ﱦ	ئم	U+FC66 ARABIC LIGATURE YEH WITH HAMZA ABOVE WITH MEEM FINAL FORM
ﱧ	ئن	U+FC67 ARABIC LIGATURE YEH WITH HAMZA ABOVE WITH NOON FINAL FORM
ﱨ	ئى	U+FC68 ARABIC LIGATURE YEH WITH HAMZA ABOVE WITH ALEF MAKSURA FINAL FORM
ﱩ	ئي	U+FC69 ARABIC LIGATURE YEH WITH HAMZA ABOVE WITH YEH FINAL FORM
ﱪ	بر	U+FC6A ARABIC LIGATURE BEH WITH REH FINAL FORM
ﱫ	بز	U+FC6B ARABIC LIGATURE BEH WITH ZAIN FINAL FORM
ﱬ	بم	U+FC6C ARABIC LIGATURE BEH WITH MEEM FINAL FORM
ﱭ	بن	U+FC6D ARABIC LIGATURE BEH WITH NOON FINAL FORM
ﱮ	بى	U+FC6E ARABIC LIGATURE BEH WITH ALEF MAKSURA FINAL FORM
ﱯ	بي	U+FC6F ARABIC LIGATURE BEH WITH YEH FINAL FORM
ﱰ	تر	U+FC70 ARABIC LIGATURE TEH WITH REH FINAL FORM
ﱱ	تز	U+FC71 ARABIC LIGATURE TEH WITH ZAIN FINAL FORM
ﱲ	تم	U+FC72 ARABIC LIGATURE TEH WITH MEEM FINAL FORM
ﱳ	تن	U+FC73 ARABIC LIGATURE TEH WITH NOON FINAL FORM
ﱴ	تى	U+FC74 ARABIC LIGATURE TEH WITH ALEF MAKSURA FINAL FORM
ﱵ	تي	U+FC75 ARABIC LIGATURE TEH WITH YEH FINAL FORM
ﱶ	ثر	U+FC76 ARABIC LIGATURE THEH WITH REH FINAL FORM
ﱷ	ثز	U+FC77 ARABIC LIGATURE THEH WITH ZAIN FINAL FORM
ﱸ	ثم	U+FC78 ARABIC LIGATURE THEH WITH MEEM FINAL FORM
ﱹ	ثن	U+FC79 ARABIC LIGATURE THEH WITH NOON FINAL FORM
ﱺ	ثى	U+FC7A ARABIC LIGATURE THEH WITH ALEF MAKSURA FINAL FORM
ﱻ	ثي	U+FC7B ARABIC LIGATURE THEH WITH YEH FINAL FORM
ﱼ	فى	U+FC7C ARABIC LIGATURE FEH WITH ALEF MAKSURA FINAL FORM
ﱽ	في	U+FC7D ARABIC LIGATURE FEH WITH YEH FINAL FORM
ﱾ	قى	U+FC7E ARABIC LIGATURE QAF WITH ALEF MAKSURA FINAL FORM
ﱿ	قي	U+FC7F ARABIC LIGATURE QAF WITH YEH FINAL FORM
ﲀ	كا	U+FC80 ARABIC LIGATURE KAF WITH ALEF FINAL FORM
ﲁ	كل	U+FC81 ARABIC LIGATURE KAF WITH LAM FINAL FORM
ﲂ	كم	U+FC82 ARABIC LIGATURE KAF WITH MEEM FINAL FORM
ﲃ	كى	U+FC83 ARABIC LIGATURE KAF WITH ALEF MAKSURA FINAL FORM
ﲄ	كي	U+FC84 ARABIC LIGATURE KAF WITH YEH FINAL FORM
ﲅ	لم	U+FC85 ARABIC LIGATURE LAM WITH MEEM FINAL FORM
ﲆ	لى	U+FC86 ARABIC LIGATURE LAM WITH ALEF MAKSURA FINAL FORM
ﲇ	لي	U+FC87 ARABIC LIGATURE LAM WITH YEH FINAL FORM
ﲈ	ما	U+FC88 ARABIC LIGATURE MEEM WITH ALEF FINAL FORM
ﲉ	مم	U+FC89 ARABIC LIGATURE MEEM WITH MEEM FINAL FORM
ﲊ	نر	U+FC8A ARABIC LIGATURE NOON WITH REH FINAL FORM
ﲋ	نز	U+FC8B ARABIC LIGATURE NOON WITH ZAIN FINAL FORM
ﲌ	نم	U+FC8C ARABIC LIGATURE NOON WITH MEEM FINAL FORM
ﲍ	نن	U+FC8D ARABIC LIGATURE NOON WITH NOON FINAL FORM
ﲎ	نى	U+FC8E ARABIC LIGATURE NOON WITH ALEF MAKSURA FINAL FORM
ﲏ	ني	U+FC8F ARABIC LIGATURE NOON WITH YEH FINAL FORM
ﲐ	ىٰ	U+FC90 ARABIC LIGATURE ALEF MAKSURA WITH SUPERSCRIPT ALEF FINAL FORM
ﲑ	ير	U+FC91 ARABIC LIGATURE YEH WITH REH FINAL FORM
ﲒ	يز	U+FC92 ARABIC LIGATURE YEH WITH ZAIN FINAL FORM
ﲓ	يم	U+FC93 ARABIC LIGATURE YEH WITH MEEM FINAL FORM
ﲔ	ين	U+FC94 ARABIC LIGATURE YEH WITH NOON FINAL FORM
ﲕ	يى	U+FC95 ARABIC LIGATURE YEH WITH ALEF MAKSURA FINAL FORM
ﲖ	يي	U+FC96 ARABIC LIGATURE YEH WITH YEH FINAL FORM
ﲗ	ئج	U+FC97 ARABIC LIGATURE YEH WITH HAMZA ABOVE WITH JEEM INITIAL FORM
ﲘ	ئح	U+FC98 ARABIC LIGATURE YEH WITH HAMZA ABOVE WITH HAH INITIAL FORM
ﲙ	ئخ	U+FC99 ARABIC LIGATURE YEH WITH HAMZA ABOVE WITH KHAH INITIAL FORM
ﲚ	ئم	U+FC9A ARABIC LIGATURE YEH WITH HAMZA ABOVE WITH MEEM INITIAL FORM
ﲛ	ئه	U+FC9B ARABIC LIGATURE YEH WITH HAMZA ABOVE WITH HEH INITIAL FORM
ﲜ	بج	U+FC9C ARABIC LIGATURE BEH WITH JEEM INITIAL FORM
ﲝ	بح	U+FC9D ARABIC LIGATURE BEH WITH HAH INITIAL FORM
ﲞ	بخ	U+FC9E ARABIC LIGATURE BEH WITH KHAH INITIAL FORM
ﲟ	بم	U+FC9F ARABIC LIGATURE BEH WITH MEEM INITIAL FORM
ﲠ	به	U+FCA0 ARABIC LIGATURE BEH WITH HEH INITIAL FORM
ﲡ	تج	U+FCA1 ARABIC LIGATURE TEH WITH JEEM INITIAL FORM
ﲢ	تح	U+FCA2 ARABIC LIGATURE TEH WITH HAH INITIAL FORM
ﲣ	تخ	U+FCA3 ARABIC LIGATURE TEH WITH KHAH INITIAL FORM
ﲤ	تم	U+FCA4 ARABIC LIGATURE TEH WITH MEEM INITIAL FORM
ﲥ	ته	U+FCA5 ARABIC LIGATURE TEH WITH HEH INITIAL FORM
ﲦ	ثم	U+FCA6 ARABIC LIGATURE THEH WITH MEEM INITIAL FORM
ﲧ	جح	U+FCA7 ARABIC LIGATURE JEEM WITH HAH INITIAL FORM
ﲨ	جم	U+FCA8 ARABIC LIGATURE JEEM WITH MEEM INITIAL FORM
ﲩ	حج	U+FCA9 ARABIC LIGATURE HAH WITH JEEM INITIAL FORM
ﲪ	حم	U+FCAA ARABIC LIGATURE HAH WITH MEEM INITIAL FORM
ﲫ	خج	U+FCAB ARABIC LIGATURE KHAH WITH JEEM INITIAL FORM
ﲬ	خم	U+FCAC ARABIC LIGATURE KHAH WITH MEEM INITIAL FORM
ﲭ	سج	U+FCAD ARABIC LIGATURE SEEN WITH JEEM INITIAL FORM
ﲮ	سح	U+FCAE ARABIC LIGATURE SEEN WITH HAH INITIAL FORM
ﲯ	سخ	U+FCAF ARABIC LIGATURE SEEN WITH KHAH INITIAL FORM
ﲰ	سم	U+FCB0 ARABIC LIGATURE SEEN WITH MEEM INITIAL FORM
ﲱ	صح	U+FCB1 ARABIC LIGATURE SAD WITH HAH INITIAL FORM
ﲲ	صخ	U+FCB2 ARABIC LIGATURE SAD WITH KHAH INITIAL FORM
ﲳ	صم	U+FCB3 ARABIC LIGATURE SAD WITH MEEM INITIAL FORM
ﲴ	ضج	U+FCB4 ARABIC LIGATURE DAD WITH JEEM INITIAL FORM
ﲵ	ضح	U+FCB5 ARABIC LIGATURE DAD WITH HAH INITIAL FORM
ﲶ	ضخ	U+FCB6 ARABIC LIGATURE DAD WITH KHAH INITIAL FORM
ﲷ	ضم	U+FCB7 ARABIC LIGATURE DAD WITH MEEM INITIAL FORM
ﲸ	طح	U+FCB8 ARABIC LIGATURE TAH WITH HAH INITIAL FORM
ﲹ	ظم	U+FCB9 ARABIC LIGATURE ZAH WITH MEEM INITIAL FORM
ﲺ	عج	U+FCBA ARABIC LIGATURE AIN WITH JEEM INITIAL FORM
ﲻ	عم	U+FCBB ARABIC LIGATURE AIN WITH MEEM INITIAL FORM
ﲼ	غج	U+FCBC ARABIC LIGATURE GHAIN WITH JEEM INITIAL FORM
ﲽ	غم	U+FCBD ARABIC LIGATURE GHAIN WITH MEEM INITIAL FORM
ﲾ	فج	U+FCBE ARABIC LIGATURE FEH WITH JEEM INITIAL FORM
ﲿ	فح	U+FCBF ARABIC LIGATURE FEH WITH HAH INITIAL FORM
ﳀ	فخ	U+FCC0 ARABIC LIGATURE FEH WITH KHAH INITIAL FORM
ﳁ	فم	U+FCC1 ARABIC LIGATURE FEH WITH MEEM INITIAL FORM
ﳂ	قح	U+FCC2 ARABIC LIGATURE QAF WITH HAH INITIAL FORM
ﳃ	قم	U+FCC3 ARABIC LIGATURE QAF WITH MEEM INITIAL FORM
ﳄ	كج	U+FCC4 ARABIC LIGATURE KAF WITH JEEM INITIAL FORM
ﳅ	كح	U+FCC5 ARABIC LIGATURE KAF WITH HAH INITIAL FORM
ﳆ	كخ	U+FCC6 ARABIC LIGATURE KAF WITH KHAH INITIAL FORM
ﳇ	كل	U+FCC7 ARABIC LIGATURE KAF WITH LAM INITIAL FORM
ﳈ	كم	U+FCC8 ARABIC LIGATURE KAF WITH MEEM INITIAL FORM
ﳉ	لج	U+FCC9 ARABIC LIGATURE LAM WITH JEEM INITIAL FORM
ﳊ	لح	U+FCCA ARABIC LIGATURE LAM WITH HAH INITIAL FORM
ﳋ	لخ	U+FCCB ARABIC LIGATURE LAM WITH KHAH INITIAL FORM
ﳌ	لم	U+FCCC ARABIC LIGATURE LAM WITH MEEM INITIAL FORM
ﳍ	له	U+FCCD ARABIC LIGATURE LAM WITH HEH INITIAL FORM
ﳎ	مج	U+FCCE ARABIC LIGATURE MEEM WITH JEEM INITIAL FORM
ﳏ	مح	U+FCCF ARABIC LIGATURE MEEM WITH HAH INITIAL FORM
ﳐ	مخ	U+FCD0 ARABIC LIGATURE MEEM WITH KHAH INITIAL FORM
ﳑ	مم	U+FCD1 ARABIC LIGATURE MEEM WITH MEEM INITIAL FORM
ﳒ	نج	U+FCD2 ARABIC LIGATURE NOON WITH JEEM INITIAL FORM
ﳓ	نح	U+FCD3 ARABIC LIGATURE NOON WITH HAH INITIAL FORM
ﳔ	نخ	U+FCD4 ARABIC LIGATURE NOON WITH KHAH INITIAL FORM
ﳕ	نم	U+FCD5 ARABIC LIGATURE NOON WITH MEEM INITIAL FORM
ﳖ	نه	U+FCD6 ARABIC LIGATURE NOON WITH HEH INITIAL FORM
ﳗ	هج	U+FCD7 ARABIC LIGATURE HEH WITH JEEM INITIAL FORM
ﳘ	هم	U+FCD8 ARABIC LIGATURE HEH WITH MEEM INITIAL FORM
ﳙ	هٰ	U+FCD9 ARABIC LIGATURE HEH WITH SUPERSCRIPT ALEF INITIAL FORM
ﳚ	يج	U+FCDA ARABIC LIGATURE YEH WITH JEEM INITIAL FORM
ﳛ	يح	U+FCDB ARABIC LIGATURE YEH WITH HAH INITIAL FORM
ﳜ	يخ	U+FCDC ARABIC LIGATURE YEH WITH KHAH INITIAL FORM
ﳝ	يم	U+FCDD ARABIC LIGATURE YEH WITH MEEM INITIAL FORM
ﳞ	يه	U+FCDE ARABIC LIGATURE YEH WITH HEH INITIAL FORM
ﳟ	ئم	U+FCDF ARABIC LIGATURE YEH WITH HAMZA ABOVE WITH MEEM MEDIAL FORM
ﳠ	ئه	U+FCE0 ARABIC LIGATURE YEH WITH HAMZA ABOVE WITH HEH MEDIAL FORM
ﳡ	بم	U+FCE1 ARABIC LIGATURE BEH WITH MEEM MEDIAL FORM
ﳢ	به	U+FCE2 ARABIC LIGATURE BEH WITH HEH MEDIAL FORM
ﳣ	تم	U+FCE3 ARABIC LIGATURE TEH WITH MEEM MEDIAL FORM
ﳤ	ته	U+FCE4 ARABIC LIGATURE TEH WITH HEH MEDIAL FORM
ﳥ	ثم	U+FCE5 ARABIC LIGATURE THEH WITH MEEM MEDIAL FORM
ﳦ	ثه	U+FCE6 ARABIC LIGATURE THEH WITH HEH MEDIAL FORM
ﳧ	سم	U+FCE7 ARABIC LIGATURE SEEN WITH MEEM MEDIAL FORM
ﳨ	سه	U+FCE8 ARABIC LIGATURE SEEN WITH HEH MEDIAL FORM
ﳩ	شم	U+FCE9 ARABIC LIGATURE SHEEN WITH MEEM MEDIAL FORM
ﳪ	شه	U+FCEA ARABIC LIGATURE SHEEN WITH HEH MEDIAL FORM
ﳫ	كل	U+FCEB ARABIC LIGATURE KAF WITH LAM MEDIAL FORM
ﳬ	كم	U+FCEC ARABIC LIGATURE KAF WITH MEEM MEDIAL FORM
ﳭ	لم	U+FCED ARABIC LIGATURE LAM WITH MEEM MEDIAL FORM
ﳮ	نم	U+FCEE ARABIC LIGATURE NOON WITH MEEM MEDIAL FORM
ﳯ	نه	U+FCEF ARABIC LIGATURE NOON WITH HEH MEDIAL FORM
ﳰ	يم	U+FCF0 ARABIC LIGATURE YEH WITH MEEM MEDIAL FORM
ﳱ	يه	U+FCF1 ARABIC LIGATURE YEH WITH HEH MEDIAL FORM
ﳲ	ـَّ	U+FCF2 ARABIC LIGATURE SHADDA WITH FATHA MEDIAL FORM
ﳳ	ـُّ	U+FCF3 ARABIC LIGATURE SHADDA WITH DAMMA MEDIAL FORM
ﳴ	ـِّ	U+FCF4 ARABIC LIGATURE SHADDA WITH KASRA MEDIAL FORM
ﳵ	طى	U+FCF5 ARABIC LIGATURE TAH WITH ALEF MAKSURA ISOLATED FORM
ﳶ	طي	U+FCF6 ARABIC LIGATURE TAH WITH YEH ISOLATED FORM
ﳷ	عى	U+FCF7 ARABIC LIGATURE AIN WITH ALEF MAKSURA ISOLATED FORM
ﳸ	عي	U+FCF8 ARABIC LIGATURE AIN WITH YEH ISOLATED FORM
ﳹ	غى	U+FCF9 ARABIC LIGATURE GHAIN WITH ALEF MAKSURA ISOLATED FORM
ﳺ	غي	U+FCFA ARABIC LIGATURE GHAIN WITH YEH ISOLATED FORM
ﳻ	سى	U+FCFB ARABIC LIGATURE SEEN WITH ALEF MAKSURA ISOLATED FORM
ﳼ	سي	U+FCFC ARABIC LIGATURE SEEN WITH YEH ISOLATED FORM
ﳽ	شى	U+FCFD ARABIC LIGATURE SHEEN WITH ALEF MAKSURA ISOLATED FORM
ﳾ	شي	U+FCFE ARABIC LIGATURE SHEEN WITH YEH ISOLATED FORM
ﳿ	حى	U+FCFF ARABIC LIGATURE HAH WITH ALEF MAKSURA ISOLATED FORM
ﴀ	حي	U+FD00 ARABIC LIGATURE HAH WITH YEH ISOLATED FORM
ﴁ	جى	U+FD01 ARABIC LIGATURE JEEM WITH ALEF MAKSURA ISOLATED FORM
ﴂ	جي	U+FD02 ARABIC LIGATURE JEEM WITH YEH ISOLATED FORM
ﴃ	خى	U+FD03 ARABIC LIGATURE KHAH WITH ALEF MAKSURA ISOLATED FORM
ﴄ	خي	U+FD04 ARABIC LIGATURE KHAH WITH YEH ISOLATED FORM
ﴅ	صى	U+FD05 ARABIC LIGATURE SAD WITH ALEF MAKSURA ISOLATED FORM
ﴆ	صي	U+FD06 ARABIC LIGATURE SAD WITH YEH ISOLATED FORM
ﴇ	ضى	U+FD07 ARABIC LIGATURE DAD WITH ALEF MAKSURA ISOLATED FORM
ﴈ	ضي	U+FD08 ARABIC LIGATURE DAD WITH YEH ISOLATED FORM
ﴉ	شج	U+FD09 ARABIC LIGATURE SHEEN WITH JEEM ISOLATED FORM
ﴊ	شح	U+FD0A ARABIC LIGATURE SHEEN WITH HAH ISOLATED FORM
ﴋ	شخ	U+FD0B ARABIC LIGATURE SHEEN WITH KHAH ISOLATED FORM
ﴌ	شم	U+FD0C ARABIC LIGATURE SHEEN WITH MEEM ISOLATED FORM
ﴍ	شر	U+FD0D ARABIC LIGATURE SHEEN WITH REH ISOLATED FORM
ﴎ	سر	U+FD0E ARABIC LIGATURE SEEN WITH REH ISOLATED FORM
ﴏ	صر	U+FD0F ARABIC LIGATURE SAD WITH REH ISOLATED FORM
ﴐ	ضر	U+FD10 ARABIC LIGATURE DAD WITH REH ISOLATED FORM
ﴑ	طى	U+FD11 ARABIC LIGATURE TAH WITH ALEF MAKSURA FINAL FORM
ﴒ	طي	U+FD12 ARABIC LIGATURE TAH WITH YEH FINAL FORM
ﴓ	عى	U+FD13 ARABIC LIGATURE AIN WITH ALEF MAKSURA FINAL FORM
ﴔ	عي	U+FD14 ARABIC LIGATURE AIN WITH YEH FINAL FORM
ﴕ	غى	U+FD15 ARABIC LIGATURE GHAIN WITH ALEF MAKSURA FINAL FORM
ﴖ	غي	U+FD16 ARABIC LIGATURE GHAIN WITH YEH FINAL FORM
ﴗ	سى	U+FD17 ARABIC LIGATURE SEEN WITH ALEF MAKSURA FINAL FORM
ﴘ	سي	U+FD18 ARABIC LIGATURE SEEN WITH YEH FINAL FORM
ﴙ	شى	U+FD19 ARABIC LIGATURE SHEEN WITH ALEF MAKSURA FINAL FORM
ﴚ	شي	U+FD1A ARABIC LIGATURE SHEEN WITH YEH FINAL FORM
ﴛ	حى	U+FD1B ARABIC LIGATURE HAH WITH ALEF MAKSURA FINAL FORM
ﴜ	حي	U+FD1C ARABIC LIGATURE HAH WITH YEH FINAL FORM
ﴝ	جى	U+FD1D ARABIC LIGATURE JEEM WITH ALEF MAKSURA FINAL FORM
ﴞ	جي	U+FD1E ARABIC LIGATURE JEEM WITH YEH FINAL FORM
ﴟ	خى	U+FD1F ARABIC LIGATURE KHAH WITH ALEF MAKSURA FINAL FORM
ﴠ	خي	U+FD20 ARABIC LIGATURE KHAH WITH YEH FINAL FORM
ﴡ	صى	U+FD21 ARABIC LIGATURE SAD WITH ALEF MAKSURA FINAL FORM
ﴢ	صي	U+FD22 ARABIC LIGATURE SAD WITH YEH FINAL FORM
ﴣ	ضى	U+FD23 ARABIC LIGATURE DAD WITH ALEF MAKSURA FINAL FORM
ﴤ	ضي	U+FD24 ARABIC LIGATURE DAD WITH YEH FINAL FORM
ﴥ	شج	U+FD25 ARABIC LIGATURE SHEEN WITH JEEM FINAL FORM
ﴦ	شح	U+FD26 ARABIC LIGATURE SHEEN WITH HAH FINAL FORM
ﴧ	شخ	U+FD27 ARABIC LIGATURE SHEEN WITH KHAH FINAL FORM
ﴨ	شم	U+FD28 ARABIC LIGATURE SHEEN WITH MEEM FINAL FORM
ﴩ	شر	U+FD29 ARABIC LIGATURE SHEEN WITH REH FINAL FORM
ﴪ	سر	U+FD2A ARABIC LIGATURE SEEN WITH REH FINAL FORM
ﴫ	صر	U+FD2B ARABIC LIGATURE SAD WITH REH FINAL FORM
ﴬ	ضر	U+FD2C ARABIC LIGATURE DAD WITH REH FINAL FORM
ﴭ	شج	U+FD2D ARABIC LIGATURE SHEEN WITH JEEM INITIAL FORM
ﴮ	شح	U+FD2E ARABIC LIGATURE SHEEN WITH HAH INITIAL FORM
ﴯ	شخ	U+FD2F ARABIC LIGATURE SHEEN WITH KHAH INITIAL FORM
ﴰ	شم	U+FD30 ARABIC LIGATURE SHEEN WITH MEEM INITIAL FORM
ﴱ	سه	U+FD31 ARABIC LIGATURE SEEN WITH HEH INITIAL FORM
ﴲ	شه	U+FD32 ARABIC LIGATURE SHEEN WITH HEH INITIAL FORM
ﴳ	طم	U+FD33 ARABIC LIGATURE TAH WITH MEEM INITIAL FORM
ﴴ	سج	U+FD34 ARABIC LIGATURE SEEN WITH JEEM MEDIAL FORM
ﴵ	سح	U+FD35 ARABIC LIGATURE SEEN WITH HAH MEDIAL FORM
ﴶ	سخ	U+FD36 ARABIC LIGATURE SEEN WITH KHAH MEDIAL FORM
ﴷ	شج	U+FD37 ARABIC LIGATURE SHEEN WITH JEEM MEDIAL FORM
ﴸ	شح	U+FD38 ARABIC LIGATURE SHEEN WITH HAH MEDIAL FORM
ﴹ	شخ	U+FD39 ARABIC LIGATURE SHEEN WITH KHAH MEDIAL FORM
ﴺ	طم	U+FD3A ARABIC LIGATURE TAH WITH MEEM MEDIAL FORM
ﴻ	ظم	U+FD3B ARABIC LIGATURE ZAH WITH MEEM MEDIAL FORM
ﴼ	اً	U+FD3C ARABIC LIGATURE ALEF WITH FATHATAN FINAL FORM
ﴽ	اً	U+FD3D ARABIC LIGATURE ALEF WITH FATHATAN ISOLATED FORM
ﵐ	تجم	U+FD50 ARABIC LIGATURE TEH WITH JEEM WITH MEEM INITIAL FORM
ﵑ	تحج	U+FD51 ARABIC LIGATURE TEH WITH HAH WITH JEEM FINAL FORM
ﵒ	تحج	U+FD52 ARABIC LIGATURE TEH WITH HAH WITH JEEM INITIAL FORM
ﵓ	تحم	U+FD53 ARABIC LIGATURE TEH WITH HAH WITH MEEM INITIAL FORM
ﵔ	تخم	U+FD54 ARABIC LIGATURE TEH WITH KHAH WITH MEEM INITIAL FORM
ﵕ	تمج	U+FD55 ARABIC LIGATURE TEH WITH MEEM WITH JEEM INITIAL FORM
ﵖ	تمح	U+FD56 ARABIC LIGATURE TEH WITH MEEM WITH HAH INITIAL FORM
ﵗ	تمخ	U+FD57 ARABIC LIGATURE TEH WITH MEEM WITH KHAH INITIAL FORM
ﵘ	جمح	U+FD58 ARABIC LIGATURE JEEM WITH MEEM WITH HAH FINAL FORM
ﵙ	جمح	U+FD59 ARABIC LIGATURE JEEM WITH MEEM WITH HAH INITIAL FORM
ﵚ	حمي	U+FD5A ARABIC LIGATURE HAH WITH MEEM WITH YEH FINAL FORM
ﵛ	حمى	U+FD5B ARABIC LIGATURE HAH WITH MEEM WITH ALEF MAKSURA FINAL FORM
ﵜ	سحج	U+FD5C ARABIC LIGATURE SEEN WITH HAH WITH JEEM INITIAL FORM
ﵝ	سجح	U+FD5D ARABIC LIGATURE SEEN WITH JEEM WITH HAH INITIAL FORM
ﵞ	سجى	U+FD5E ARABIC LIGATURE SEEN WITH JEEM WITH ALEF MAKSURA FINAL FORM
ﵟ	سمح	U+FD5F ARABIC LIGATURE SEEN WITH MEEM WITH HAH FINAL FORM
ﵠ	سمح	U+FD60 ARABIC LIGATURE SEEN WITH MEEM WITH HAH INITIAL FORM
ﵡ	سمج	U+FD61 ARABIC LIGATURE SEEN WITH MEEM WITH JEEM INITIAL FORM
ﵢ	سمم	U+FD62 ARABIC LIGATURE SEEN WITH MEEM WITH MEEM FINAL FORM
ﵣ	سمم	U+FD63 ARABIC LIGATURE SEEN WITH MEEM WITH MEEM INITIAL FORM
ﵤ	صحح	U+FD64 ARABIC LIGATURE SAD WITH HAH WITH HAH FINAL FORM
ﵥ	صحح	U+FD65 ARABIC LIGATURE SAD WITH HAH WITH HAH INITIAL FORM
ﵦ	صمم	U+FD66 ARABIC LIGATURE SAD WITH MEEM WITH MEEM FINAL FORM
ﵧ	شحم	U+FD67 ARABIC LIGATURE SHEEN WITH HAH WITH MEEM FINAL FORM
ﵨ	شحم	U+FD68 ARABIC LIGATURE SHEEN WITH HAH WITH MEEM INITIAL FORM
ﵩ	شجي	U+FD69 ARABIC LIGATURE SHEEN WITH JEEM WITH YEH FINAL FORM
ﵪ	شمخ	U+FD6A ARABIC LIGATURE SHEEN WITH MEEM WITH KHAH FINAL FORM
ﵫ	شمخ	U+FD6B ARABIC LIGATURE SHEEN WITH MEEM WITH KHAH INITIAL FORM
ﵬ	شمم	U+FD6C ARABIC LIGATURE SHEEN WITH MEEM WITH MEEM FINAL FORM
ﵭ	شمم	U+FD6D ARABIC LIGATURE SHEEN WITH MEEM WITH MEEM INITIAL FORM
ﵮ	ضحى	U+FD6E ARABIC LIGATURE DAD WITH HAH WITH ALEF MAKSURA FINAL FORM
ﵯ	ضخم	U+FD6F ARABIC LIGATURE DAD WITH KHAH WITH MEEM FINAL FORM
ﵰ	ضخم	U+FD70 ARABIC LIGATURE DAD WITH KHAH WITH MEEM INITIAL FORM
ﵱ	طمح	U+FD71 ARABIC LIGATURE TAH WITH MEEM WITH HAH FINAL FORM
ﵲ	طمح	U+FD72 ARABIC LIGATURE TAH WITH MEEM WITH HAH INITIAL FORM
ﵳ	طمم	U+FD73 ARABIC LIGATURE TAH WITH MEEM WITH MEEM INITIAL FORM
ﵴ	طمي	U+FD74 ARABIC LIGATURE TAH WITH MEEM WITH YEH FINAL FORM
ﵵ	عجم	U+FD75 ARABIC LIGATURE AIN WITH JEEM WITH MEEM FINAL FORM
ﵶ	عمم	U+FD76 ARABIC LIGATURE AIN WITH MEEM WITH MEEM FINAL FORM
ﵷ	عمم	U+FD77 ARABIC LIGATURE AIN WITH MEEM WITH MEEM INITIAL FORM
ﵸ	عمى	U+FD78 ARABIC LIGATURE AIN WITH MEEM WITH ALEF MAKSURA FINAL FORM
ﵹ	غمم	U+FD79 ARABIC LIGATURE GHAIN WITH MEEM WITH MEEM FINAL FORM
ﵺ	غمي	U+FD7A ARABIC LIGATURE GHAIN WITH MEEM WITH YEH FINAL FORM
ﵻ	غمى	U+FD7B ARABIC LIGATURE GHAIN WITH MEEM WITH ALEF MAKSURA FINAL FORM
ﵼ	فخم	U+FD7C ARABIC LIGATURE FEH WITH KHAH WITH MEEM FINAL FORM
ﵽ	فخم	U+FD7D ARABIC LIGATURE FEH WITH KHAH WITH MEEM INITIAL FORM
ﵾ	قمح	U+FD7E ARABIC LIGATURE QAF WITH MEEM WITH HAH FINAL FORM
ﵿ	قمم	U+FD7F ARABIC LIGATURE QAF WITH MEEM WITH MEEM FINAL FORM
ﶀ	لحم	U+FD80 ARABIC LIGATURE LAM WITH HAH WITH MEEM FINAL FORM
ﶁ	لحي	U+FD81 ARABIC LIGATURE LAM WITH HAH WITH YEH FINAL FORM
ﶂ	لحى	U+FD82 ARABIC LIGATURE LAM WITH HAH WITH ALEF MAKSURA FINAL FORM
ﶃ	لجج	U+FD83 ARABIC LIGATURE LAM WITH JEEM WITH JEEM INITIAL FORM
ﶄ	لجج	U+FD84 ARABIC LIGATURE LAM WITH JEEM WITH JEEM FINAL FORM
ﶅ	لخم	U+FD85 ARABIC LIGATURE LAM WITH KHAH WITH MEEM FINAL FORM
ﶆ	لخم	U+FD86 ARABIC LIGATURE LAM WITH KHAH WITH MEEM INITIAL FORM
ﶇ	لمح	U+FD87 ARABIC LIGATURE LAM WITH MEEM WITH HAH FINAL FORM
ﶈ	لمح	U+FD88 ARABIC LIGATURE LAM WITH MEEM WITH HAH INITIAL FORM
ﶉ	محج	U+FD89 ARABIC LIGATURE MEEM WITH HAH WITH JEEM INITIAL FORM
ﶊ	محم	U+FD8A ARABIC LIGATURE MEEM WITH HAH WITH MEEM INITIAL FORM
ﶋ	محي	U+FD8B ARABIC LIGATURE MEEM WITH HAH WITH YEH FINAL FORM
ﶌ	مجح	U+FD8C ARABIC LIGATURE MEEM WITH JEEM WITH HAH INITIAL FORM
ﶍ	مجم	U+FD8D ARABIC LIGATURE MEEM WITH JEEM WITH MEEM INITIAL FORM
ﶎ	مخج	U+FD8E ARABIC LIGATURE MEEM WITH KHAH WITH JEEM INITIAL FORM
ﶏ	مخم	U+FD8F ARABIC LIGATURE MEEM WITH KHAH WITH MEEM INITIAL FORM
ﶒ	مجخ	U+FD92 ARABIC LIGATURE MEEM WITH JEEM WITH KHAH INITIAL FORM
ﶓ	همج	U+FD93 ARABIC LIGATURE HEH WITH MEEM WITH JEEM INITIAL FORM
ﶔ	همم	U+FD94 ARABIC LIGATURE HEH WITH MEEM WITH MEEM INITIAL FORM
ﶕ	نحم	U+FD95 ARABIC LIGATURE NOON WITH HAH WITH MEEM INITIAL FORM
ﶖ	نحى	U+FD96 ARABIC LIGATURE NOON WITH HAH WITH ALEF MAKSURA FINAL FORM
ﶗ	نجم	U+FD97 ARABIC LIGATURE NOON WITH JEEM WITH MEEM FINAL FORM
ﶘ	نجم	U+FD98 ARABIC LIGATURE NOON WITH JEEM WITH MEEM INITIAL FORM
ﶙ	نجى	U+FD99 ARABIC LIGATURE NOON WITH JEEM WITH ALEF MAKSURA FINAL FORM
ﶚ	نمي	U+FD9A ARABIC LIGATURE NOON WITH MEEM WITH YEH FINAL FORM
ﶛ	نمى	U+FD9B ARABIC LIGATURE NOON WITH MEEM WITH ALEF MAKSURA FINAL FORM
ﶜ	يمم	U+FD9C ARABIC LIGATURE YEH WITH MEEM WITH MEEM FINAL FORM
ﶝ	يمم	U+FD9D ARABIC LIGATURE YEH WITH MEEM WITH MEEM INITIAL FORM
ﶞ	بخي	U+FD9E ARABIC LIGATURE BEH WITH KHAH WITH YEH FINAL FORM
ﶟ	تجي	U+FD9F ARABIC LIGATURE TEH WITH JEEM WITH YEH FINAL FORM
ﶠ	تجى	U+FDA0 ARABIC LIGATURE TEH WITH JEEM WITH ALEF MAKSURA FINAL FORM
ﶡ	تخي	U+FDA1 ARABIC LIGATURE TEH WITH KHAH WITH YEH FINAL FORM
ﶢ	تخى	U+FDA2 ARABIC LIGATURE TEH WITH KHAH WITH ALEF MAKSURA FINAL FORM
ﶣ	تمي	U+FDA3 ARABIC LIGATURE TEH WITH MEEM WITH YEH FINAL FORM
ﶤ	تمى	U+FDA4 ARABIC LIGATURE TEH WITH MEEM WITH ALEF MAKSURA FINAL FORM
ﶥ	جمي	U+FDA5 ARABIC LIGATURE JEEM WITH MEEM WITH YEH FINAL FORM
ﶦ	جحى	U+FDA6 ARABIC LIGATURE JEEM WITH HAH WITH ALEF MAKSURA FINAL FORM
ﶧ	جمى	U+FDA7 ARABIC LIGATURE JEEM WITH MEEM WITH ALEF MAKSURA FINAL FORM
ﶨ	سخى	U+FDA8 ARABIC LIGATURE SEEN WITH KHAH WITH ALEF MAKSURA FINAL FORM
ﶩ	صحي	U+FDA9 ARABIC LIGATURE SAD WITH HAH WITH YEH FINAL FORM
ﶪ	شحي	U+FDAA ARABIC LIGATURE SHEEN WITH HAH WITH YEH FINAL FORM
ﶫ	ضحي	U+FDAB ARABIC LIGATURE DAD WITH HAH WITH YEH FINAL FORM
ﶬ	لجي	U+FDAC ARABIC LIGATURE LAM WITH JEEM WITH YEH FINAL FORM
ﶭ	لمي	U+FDAD ARABIC LIGATURE LAM WITH MEEM WITH YEH FINAL FORM
ﶮ	يحي	U+FDAE ARABIC LIGATURE YEH WITH HAH WITH YEH FINAL FORM
ﶯ	يجي	U+FDAF ARABIC LIGATURE YEH WITH JEEM WITH YEH FINAL FORM
ﶰ	يمي	U+FDB0 ARABIC LIGATURE YEH WITH MEEM WITH YEH FINAL FORM
ﶱ	ممي	U+FDB1 ARABIC LIGATURE MEEM WITH MEEM WITH YEH FINAL FORM
ﶲ	قمي	U+FDB2 ARABIC LIGATURE QAF WITH MEEM WITH YEH FINAL FORM
ﶳ	نحي	U+FDB3 ARABIC LIGATURE NOON WITH HAH WITH YEH FINAL FORM
ﶴ	قمح	U+FDB4 ARABIC LIGATURE QAF WITH MEEM WITH HAH INITIAL FORM
ﶵ	لحم	U+FDB5 ARABIC LIGATURE LAM WITH HAH WITH MEEM INITIAL FORM
ﶶ	عمي	U+FDB6 ARABIC LIGATURE AIN WITH MEEM WITH YEH FINAL FORM
ﶷ	كمي	U+FDB7 ARABIC LIGATURE KAF WITH MEEM WITH YEH FINAL FORM
ﶸ	نجح	U+FDB8 ARABIC LIGATURE NOON WITH JEEM WITH HAH INITIAL FORM
ﶹ	مخي	U+FDB9 ARABIC LIGATURE MEEM WITH KHAH WITH YEH FINAL FORM
ﶺ	لجم	U+FDBA ARABIC LIGATURE LAM WITH JEEM WITH MEEM INITIAL FORM
ﶻ	كمم	U+FDBB ARABIC LIGATURE KAF WITH MEEM WITH MEEM FINAL FORM
ﶼ	لجم	U+FDBC ARABIC LIGATURE LAM WITH JEEM WITH MEEM FINAL FORM
ﶽ	نجح	U+FDBD ARABIC LIGATURE NOON WITH JEEM WITH HAH FINAL FORM
ﶾ	جحي	U+FDBE ARABIC LIGATURE JEEM WITH HAH WITH YEH FINAL FORM
ﶿ	حجي	U+FDBF ARABIC LIGATURE HAH WITH JEEM WITH YEH FINAL FORM
ﷀ	مجي	U+FDC0 ARABIC LIGATURE MEEM WITH JEEM WITH YEH FINAL FORM
ﷁ	فمي	U+FDC1 ARABIC LIGATURE FEH WITH MEEM WITH YEH FINAL FORM
ﷂ	بحي	U+FDC2 ARABIC LIGATURE BEH WITH HAH WITH YEH FINAL FORM
ﷃ	كمم	U+FDC3 ARABIC LIGATURE KAF WITH MEEM WITH MEEM INITIAL FORM
ﷄ	عجم	U+FDC4 ARABIC LIGATURE AIN WITH JEEM WITH MEEM INITIAL FORM
ﷅ	صمم	U+FDC5 ARABIC LIGATURE SAD WITH MEEM WITH MEEM INITIAL FORM
ﷆ	سخي	U+FDC6 ARABIC LIGATURE SEEN WITH KHAH WITH YEH FINAL FORM
ﷇ	نجي	U+FDC7 ARABIC LIGATURE NOON WITH JEEM WITH YEH FINAL FORM
ﷰ	صلے	U+FDF0 ARABIC LIGATURE SALLA USED AS KORANIC STOP SIGN ISOLATED FORM
ﷱ	قلے	U+FDF1 ARABIC LIGATURE QALA USED AS KORANIC STOP SIGN ISOLATED FORM
ﷲ	الله	U+FDF2 ARABIC LIGATURE ALLAH ISOLATED FORM
ﷳ	اكبر	U+FDF3 ARABIC LIGATURE AKBAR ISOLATED FORM
ﷴ	محمد	U+FDF4 ARABIC LIGATURE MOHAMMAD ISOLATED FORM
ﷵ	صلعم	U+FDF5 ARABIC LIGATURE SALAM ISOLATED FORM
ﷶ	رسول	U+FDF6 ARABIC LIGATURE RASOUL ISOLATED FORM
ﷷ	عليه	U+FDF7 ARABIC LIGATURE ALAYHE ISOLATED FORM
ﷸ	وسلم	U+FDF8 ARABIC LIGATURE WASALLAM ISOLATED FORM
ﷹ	صلى	U+FDF9 ARABIC LIGATURE SALLA ISOLATED FORM
ﷺ	صلى الله عليه وسلم	U+FDFA ARABIC LIGATURE SALLALLAHOU ALAYHE WASALLAM
ﷻ	جل جلاله	U+FDFB ARABIC LIGATURE JALLAJALALOUHOU
﷼	ریال	U+FDFC RIAL SIGN
ﹰ	 ً	U+FE70 ARABIC FATHATAN ISOLATED FORM
ﹱ	ـً	U+FE71 ARABIC TATWEEL WITH FATHATAN ABOVE
ﹲ	 ٌ	U+FE72 ARABIC DAMMATAN ISOLATED FORM
ﹴ	 ٍ	U+FE74 ARABIC KASRATAN ISOLATED FORM
ﹶ	 َ	U+FE76 ARABIC FATHA ISOLATED FORM
ﹷ	ـَ	U+FE77 ARABIC FATHA MEDIAL FORM
ﹸ	 ُ	U+FE78 ARABIC DAMMA ISOLATED FORM
ﹹ	ـُ	U+FE79 ARABIC DAMMA MEDIAL FORM
ﹺ	 ِ	U+FE7A ARABIC KASRA ISOLATED FORM
ﹻ	ـِ	U+FE7B ARABIC KASRA MEDIAL FORM
ﹼ	 ّ	U+FE7C ARABIC SHADDA ISOLATED FORM
ﹽ	ـّ	U+FE7D ARABIC SHADDA MEDIAL FORM
ﹾ	 ْ	U+FE7E ARABIC SUKUN ISOLATED FORM
ﹿ	ـْ	U+FE7F ARABIC SUKUN MEDIAL FORM
ﺀ	ء	U+FE80 ARABIC LETTER HAMZA ISOLATED FORM
ﺁ	آ	U+FE81 ARABIC LETTER ALEF WITH MADDA ABOVE ISOLATED FORM
ﺂ	آ	U+FE82 ARABIC LETTER ALEF WITH MADDA ABOVE FINAL FORM
ﺃ	أ	U+FE83 ARABIC LETTER ALEF WITH HAMZA ABOVE ISOLATED FORM
ﺄ	أ	U+FE84 ARABIC LETTER ALEF WITH HAMZA ABOVE FINAL FORM
ﺅ	ؤ	U+FE85 ARABIC LETTER WAW WITH HAMZA ABOVE ISOLATED FORM
ﺆ	ؤ	U+FE86 ARABIC LETTER WAW WITH HAMZA ABOVE FINAL FORM
ﺇ	إ	U+FE87 ARABIC LETTER ALEF WITH HAMZA BELOW ISOLATED FORM
ﺈ	إ	U+FE88 ARABIC LETTER ALEF WITH HAMZA BELOW FINAL FORM
ﺉ	ئ	U+FE89 ARABIC LETTER YEH WITH HAMZA ABOVE ISOLATED FORM
ﺊ	ئ	U+FE8A ARABIC LETTER YEH WITH HAMZA ABOVE FINAL FORM
ﺋ	ئ	U+FE8B ARABIC LETTER YEH WITH HAMZA ABOVE INITIAL FORM
ﺌ	ئ	U+FE8C ARABIC LETTER YEH WITH HAMZA ABOVE MEDIAL FORM
ﺍ	ا	U+FE8D ARABIC LETTER ALEF ISOLATED FORM
ﺎ	ا	U+FE8E ARABIC LETTER ALEF FINAL FORM
ﺏ	ب	U+FE8F ARABIC LETTER BEH ISOLATED FORM
ﺐ	ب	U+FE90 ARABIC LETTER BEH FINAL FORM
ﺑ	ب	U+FE91 ARABIC LETTER BEH INITIAL FORM
ﺒ	ب	U+FE92 ARABIC LETTER BEH MEDIAL FORM
ﺓ	ة	U+FE93 ARABIC LETTER TEH MARBUTA ISOLATED FORM
ﺔ	ة	U+FE94 ARABIC LETTER TEH MARBUTA FINAL FORM
ﺕ	ت	U+FE95 ARABIC LETTER TEH ISOLATED FORM
ﺖ	ت	U+FE96 ARABIC LETTER TEH FINAL FORM
ﺗ	ت	U+FE97 ARABIC LETTER TEH INITIAL FORM
ﺘ	ت	U+FE98 ARABIC LETTER TEH MEDIAL FORM
ﺙ	ث	U+FE99 ARABIC LETTER THEH ISOLATED FORM
ﺚ	ث	U+FE9A ARABIC LETTER THEH FINAL FORM
ﺛ	ث	U+FE9B ARABIC LETTER THEH INITIAL FORM
ﺜ	ث	U+FE9C ARABIC LETTER THEH MEDIAL FORM
ﺝ	ج	U+FE9D ARABIC LETTER JEEM ISOLATED FORM
ﺞ	ج	U+FE9E ARABIC LETTER JEEM FINAL FORM
ﺟ	ج	U+FE9F ARABIC LETTER JEEM INITIAL FORM
ﺠ	ج	U+FEA0 ARABIC LETTER JEEM MEDIAL FORM
ﺡ	ح	U+FEA1 ARABIC LETTER HAH ISOLATED FORM
ﺢ	ح	U+FEA2 ARABIC LETTER HAH FINAL FORM
ﺣ	ح	U+FEA3 ARABIC LETTER HAH INITIAL FORM
ﺤ	ح	U+FEA4 ARABIC LETTER HAH MEDIAL FORM
ﺥ	خ	U+FEA5 ARABIC LETTER KHAH ISOLATED FORM
ﺦ	خ	U+FEA6 ARABIC LETTER KHAH FINAL FORM
ﺧ	خ	U+FEA7 ARABIC LETTER KHAH INITIAL FORM
ﺨ	خ	U+FEA8 ARABIC LETTER KHAH MEDIAL FORM
ﺩ	د	U+FEA9 ARABIC LETTER DAL ISOLATED FORM
ﺪ	د	U+FEAA ARABIC LETTER DAL FINAL FORM
ﺫ	ذ	U+FEAB ARABIC LETTER THAL ISOLATED FORM
ﺬ	ذ	U+FEAC ARABIC LETTER THAL FINAL FORM
ﺭ	ر	U+FEAD ARABIC LETTER REH ISOLATED FORM
ﺮ	ر	U+FEAE ARABIC LETTER REH FINAL FORM
ﺯ	ز	U+FEAF ARABIC LETTER ZAIN ISOLATED FORM
ﺰ	ز	U+FEB0 ARABIC LETTER ZAIN FINAL FORM
ﺱ	س	U+FEB1 ARABIC LETTER SEEN ISOLATED FORM
ﺲ	س	U+FEB2 ARABIC LETTER SEEN FINAL FORM
ﺳ	س	U+FEB3 ARABIC LETTER SEEN INITIAL FORM
ﺴ	س	U+FEB4 ARABIC LETTER SEEN MEDIAL FORM
ﺵ	ش	U+FEB5 ARABIC LETTER SHEEN ISOLATED FORM
ﺶ	ش	U+FEB6 ARABIC LETTER SHEEN FINAL FORM
ﺷ	ش	U+FEB7 ARABIC LETTER SHEEN INITIAL FORM
ﺸ	ش	U+FEB8 ARABIC LETTER SHEEN MEDIAL FORM
ﺹ	ص	U+FEB9 ARABIC LETTER SAD ISOLATED FORM
ﺺ	ص	U+FEBA ARABIC LETTER SAD FINAL FORM
ﺻ	ص	U+FEBB ARABIC LETTER SAD INITIAL FORM
ﺼ	ص	U+FEBC ARABIC LETTER SAD MEDIAL FORM
ﺽ	ض	U+FEBD ARABIC LETTER DAD ISOLATED FORM
ﺾ	ض	U+FEBE ARABIC LETTER DAD FINAL FORM
ﺿ	ض	U+FEBF ARABIC LETTER DAD INITIAL FORM
ﻀ	ض	U+FEC0 ARABIC LETTER DAD MEDIAL FORM
ﻁ	ط	U+FEC1 ARABIC LETTER TAH ISOLATED FORM
ﻂ	ط	U+FEC2 ARABIC LETTER TAH FINAL FORM
ﻃ	ط	U+FEC3 ARABIC LETTER TAH INITIAL FORM
ﻄ	ط	U+FEC4 ARABIC LETTER TAH MEDIAL FORM
ﻅ	ظ	U+FEC5 ARABIC LETTER ZAH ISOLATED FORM
ﻆ	ظ	U+FEC6 ARABIC LETTER ZAH FINAL FORM
ﻇ	ظ	U+FEC7 ARABIC LETTER ZAH INITIAL FORM
ﻈ	ظ	U+FEC8 ARABIC LETTER ZAH MEDIAL FORM
ﻉ	ع	U+FEC9 ARABIC LETTER AIN ISOLATED FORM
ﻊ	ع	U+FECA ARABIC LETTER AIN FINAL FORM
ﻋ	ع	U+FECB ARABIC LETTER AIN INITIAL FORM
ﻌ	ع	U+FECC ARABIC LETTER AIN MEDIAL FORM
ﻍ	غ	U+FECD ARABIC LETTER GHAIN ISOLATED FORM
ﻎ	غ	U+FECE ARABIC LETTER GHAIN FINAL FORM
ﻏ	غ	U+FECF ARABIC LETTER GHAIN INITIAL FORM
ﻐ	غ	U+FED0 ARABIC LETTER GHAIN MEDIAL FORM
ﻑ	ف	U+FED1 ARABIC LETTER FEH ISOLATED FORM
ﻒ	ف	U+FED2 ARABIC LETTER FEH FINAL FORM
ﻓ	ف	U+FED3 ARABIC LETTER FEH INITIAL FORM
ﻔ	ف	U+FED4 ARABIC LETTER FEH MEDIAL FORM
ﻕ	ق	U+FED5 ARABIC LETTER QAF ISOLATED FORM
ﻖ	ق	U+FED6 ARABIC LETTER QAF FINAL FORM
ﻗ	ق	U+FED7 ARABIC LETTER QAF INITIAL FORM
ﻘ	ق	U+FED8 ARABIC LETTER QAF MEDIAL FORM
ﻙ	ك	U+FED9 ARABIC LETTER KAF ISOLATED FORM
ﻚ	ك	U+FEDA ARABIC LETTER KAF FINAL FORM
ﻛ	ك	U+FEDB ARABIC LETTER KAF INITIAL FORM
ﻜ	ك	U+FEDC ARABIC LETTER KAF MEDIAL FORM
ﻝ	ل	U+FEDD ARABIC LETTER LAM ISOLATED FORM
ﻞ	ل	U+FEDE ARABIC LETTER LAM FINAL FORM
ﻟ	ل	U+FEDF ARABIC LETTER LAM INITIAL FORM
ﻠ	ل	U+FEE0 ARABIC LETTER LAM MEDIAL FORM
ﻡ	م	U+FEE1 ARABIC LETTER MEEM ISOLATED FORM
ﻢ	م	U+FEE2 ARABIC LETTER MEEM FINAL FORM
ﻣ	م	U+FEE3 ARABIC LETTER MEEM INITIAL FORM
ﻤ	م	U+FEE4 ARABIC LETTER MEEM MEDIAL FORM
ﻥ	ن	U+FEE5 ARABIC LETTER NOON ISOLATED FORM
ﻦ	ن	U+FEE6 ARABIC LETTER NOON FINAL FORM
ﻧ	ن	U+FEE7 ARABIC LETTER NOON INITIAL FORM
ﻨ	ن	U+FEE8 ARABIC LETTER NOON MEDIAL FORM
ﻩ	ه	U+FEE9 ARABIC LETTER HEH ISOLATED FORM
ﻪ	ه	U+FEEA ARABIC LETTER HEH FINAL FORM
ﻫ	ه	U+FEEB ARABIC LETTER HEH INITIAL FORM
ﻬ	ه	U+FEEC ARABIC LETTER HEH MEDIAL FORM
ﻭ	و	U+FEED ARABIC LETTER WAW ISOLATED FORM
ﻮ	و	U+FEEE ARABIC LETTER WAW FINAL FORM
ﻯ	ى	U+FEEF ARABIC LETTER ALEF MAKSURA ISOLATED FORM
ﻰ	ى	U+FEF0 ARABIC LETTER ALEF MAKSURA FINAL FORM
ﻱ	ي	U+FEF1 ARABIC LETTER YEH ISOLATED FORM
ﻲ	ي	U+FEF2 ARABIC LETTER YEH FINAL FORM
ﻳ	ي	U+FEF3 ARABIC LETTER YEH INITIAL FORM
ﻴ	ي	U+FEF4 ARABIC LETTER YEH MEDIAL FORM
ﻵ	لآ	U+FEF5 ARABIC LIGATURE LAM WITH ALEF WITH MADDA ABOVE ISOLATED FORM
ﻶ	لآ	U+FEF6 ARABIC LIGATURE LAM WITH ALEF WITH MADDA ABOVE FINAL FORM
ﻷ	لأ	U+FEF7 ARABIC LIGATURE LAM WITH ALEF WITH HAMZA ABOVE ISOLATED FORM
ﻸ	لأ	U+FEF8 ARABIC LIGATURE LAM WITH ALEF WITH HAMZA ABOVE FINAL FORM
ﻹ	لإ	U+FEF9 ARABIC LIGATURE LAM WITH ALEF WITH HAMZA BELOW ISOLATED FORM
ﻺ	لإ	U+FEFA ARABIC LIGATURE LAM WITH ALEF WITH HAMZA BELOW FINAL FORM
ﻻ	لا	U+FEFB ARABIC LIGATURE LAM WITH ALEF ISOLATED FORM
ﻼ	لا	U+FEFC ARABIC LIGATURE LAM WITH ALEF FINAL FORM
